0100000110
1110011100
0111111000
0011100000
0000011000
0111111100
0000111110
0011111000
0000011100
0011110000
